40 120
00 00 00 00 00 00 00 00 00 00 00 00 00 00 00 00 00 00 00 00 00 00 00 00 00 00 00 00 00 00 00 00 00 00 00 00 00 00 00 00 
00 00 00 00 00 00 00 00 00 00 00 00 00 00 00 00 00 00 00 00 00 00 00 00 00 00 00 00 00 00 00 00 00 00 00 00 00 00 00 00 
00 00 00 00 00 00 00 00 00 00 00 00 00 00 00 00 00 00 00 00 00 00 00 00 00 00 00 00 00 00 00 00 00 00 00 00 00 00 00 00 
00 00 00 00 00 00 00 00 00 00 00 00 00 00 00 00 00 00 00 00 00 00 00 00 00 00 00 00 00 00 00 00 00 00 00 00 00 00 00 00 
00 00 00 00 00 00 00 00 00 00 00 00 00 00 00 00 00 00 00 00 00 00 00 00 00 00 00 00 00 00 00 00 00 00 00 00 00 00 00 00 
00 00 00 00 00 00 00 00 00 00 00 00 00 00 00 00 00 00 00 00 00 00 00 00 00 00 00 00 00 00 00 00 00 00 00 00 00 00 00 00 
00 00 00 00 00 00 00 00 00 00 00 00 00 00 00 00 00 00 00 00 00 00 00 00 00 00 00 00 00 00 00 00 00 00 00 00 00 00 00 00 
00 00 00 00 00 00 00 00 00 00 00 00 00 00 00 00 00 00 00 00 00 00 00 00 00 00 00 00 00 00 00 00 00 00 00 00 00 00 00 00 
00 00 00 00 00 00 00 00 00 00 00 00 00 00 00 00 00 00 00 00 00 00 00 00 00 00 00 00 00 00 00 00 00 00 00 00 00 00 00 00 
00 00 00 00 00 00 00 00 00 00 00 00 00 00 00 00 00 00 00 00 00 00 00 00 00 00 00 00 00 00 00 00 00 00 00 00 00 00 00 00 
00 00 00 00 00 00 00 00 00 00 00 00 00 00 00 00 00 00 07 07 07 00 00 00 00 00 00 00 00 00 00 00 00 00 00 00 00 00 00 00 
00 00 00 00 00 00 00 00 00 00 00 00 00 00 00 00 00 07 07 07 07 07 00 00 00 00 00 00 00 00 00 00 00 00 00 00 00 00 00 00 
00 00 00 00 00 00 00 00 00 00 00 00 00 00 00 00 07 07 07 07 07 07 07 00 00 00 00 00 00 00 00 00 00 00 00 00 00 00 00 00 
00 00 00 00 00 00 00 00 00 00 00 00 00 00 07 07 07 07 07 07 07 07 07 00 00 00 00 00 00 00 00 00 00 00 00 00 00 00 00 00 
00 00 00 00 00 00 00 00 00 00 00 00 00 07 07 07 07 07 07 07 07 07 07 07 00 00 00 00 00 00 00 00 00 00 00 00 00 00 00 00 
00 00 00 00 00 00 00 00 00 00 00 00 07 07 07 07 07 07 07 07 07 07 07 07 07 07 07 00 00 00 00 00 00 00 00 00 00 00 00 00 
00 00 00 00 00 00 00 00 00 00 00 07 07 07 07 07 07 07 07 07 07 07 07 07 07 07 07 07 00 00 00 00 00 00 00 00 00 00 00 00 
00 00 00 00 00 00 00 00 00 00 07 07 07 07 07 07 07 07 07 07 07 07 07 07 07 07 07 07 07 00 00 00 00 00 00 00 00 00 00 00 
00 00 00 00 00 00 00 00 00 07 07 07 07 07 07 07 07 07 07 07 07 07 07 07 07 07 07 07 07 07 00 00 00 00 00 00 00 00 00 00 
00 00 00 00 00 00 00 00 07 07 07 07 07 07 07 07 07 07 07 07 07 07 07 07 07 07 07 07 07 07 00 00 00 00 00 00 00 00 00 00 
00 00 00 00 00 00 00 00 07 07 07 07 07 07 07 07 07 07 07 07 07 07 07 07 07 07 07 07 07 07 07 00 00 00 00 00 00 00 00 00 
00 00 00 00 00 00 00 07 07 07 07 07 07 07 07 07 07 07 07 00 00 07 07 07 07 07 07 07 07 07 07 00 00 00 00 00 00 00 00 00 
00 00 00 00 00 00 07 07 07 07 07 07 07 07 07 07 07 07 04 04 04 04 07 07 07 07 07 07 07 07 07 07 07 00 00 00 00 00 00 00 
00 00 00 00 00 07 07 07 07 07 07 07 07 07 07 07 07 07 04 04 04 04 07 07 07 07 07 07 07 07 07 07 07 07 00 00 00 00 00 00 
00 00 00 00 00 07 07 07 07 07 07 07 07 07 07 07 07 07 04 04 04 04 04 07 07 07 07 07 07 07 07 07 07 07 07 07 00 00 00 00 
00 00 00 00 07 07 07 07 07 07 07 07 07 07 07 07 07 04 04 04 04 04 04 04 07 07 07 07 07 07 07 07 07 07 07 07 07 00 00 00 
00 00 00 00 07 07 07 07 07 07 07 07 07 07 07 07 04 04 04 04 04 04 04 04 07 07 07 07 07 07 07 07 07 07 07 07 07 07 00 00 
00 00 00 07 07 07 07 07 07 07 07 07 07 07 07 07 04 04 04 04 04 04 04 04 07 07 07 07 07 07 07 07 07 07 07 07 07 07 00 00 
00 07 07 07 07 07 07 07 07 07 07 07 07 07 07 07 04 04 04 04 04 04 04 04 07 07 07 07 07 07 07 07 07 07 07 07 07 07 07 00 
07 07 07 07 07 07 07 07 07 07 07 07 07 07 07 07 04 04 04 04 04 04 04 04 07 07 07 07 07 07 07 07 07 07 07 07 07 07 07 00 
07 07 07 07 07 07 07 07 07 07 07 07 07 07 07 07 04 04 04 04 04 04 04 04 07 07 07 07 07 07 07 07 07 07 07 07 07 07 07 07 
07 07 07 07 07 07 07 07 07 07 07 07 07 07 07 07 04 04 04 04 04 04 04 04 07 07 07 07 07 07 07 07 07 07 07 07 07 07 07 07 
07 07 07 07 07 07 07 04 04 04 04 04 04 04 04 04 04 04 04 04 04 04 04 04 04 04 04 04 07 07 07 07 07 07 07 07 07 07 07 07 
07 07 07 07 07 04 04 04 04 04 04 04 04 04 04 04 04 04 04 04 04 04 04 04 04 04 04 04 04 07 07 07 07 07 07 07 07 07 07 07 
07 07 07 07 07 04 04 04 04 04 04 04 04 04 04 04 04 04 04 04 04 04 04 04 04 04 04 04 04 07 07 07 07 07 07 07 07 07 07 07 
07 07 07 07 07 04 04 04 04 04 04 04 04 04 04 04 04 04 04 04 04 04 04 04 04 04 04 04 04 07 07 07 07 07 07 07 07 07 07 07 
07 07 07 07 07 04 04 04 04 04 04 04 04 04 04 04 04 04 04 04 04 04 04 04 04 04 04 04 04 07 07 07 07 07 07 07 07 07 07 07 
07 07 07 07 07 07 04 04 04 04 04 04 04 04 04 04 04 04 04 04 04 04 04 04 04 04 04 07 07 07 07 07 07 07 07 07 07 07 07 07 
07 07 07 07 07 07 07 07 04 04 04 04 04 04 04 04 07 07 07 07 07 07 07 07 07 07 07 07 07 07 07 07 07 07 07 07 07 07 07 07 
07 07 07 07 07 07 07 07 07 04 04 04 04 04 07 07 07 07 07 07 07 07 07 07 07 07 07 07 07 07 07 07 07 07 07 07 07 07 07 07 
07 07 07 07 07 07 07 07 07 04 04 04 04 04 07 07 07 07 07 07 07 07 07 07 07 07 07 07 07 07 07 07 07 07 07 07 07 07 07 07 
07 07 07 07 07 07 07 07 07 04 04 04 04 04 07 07 07 07 07 07 07 07 07 07 07 07 07 07 07 07 07 07 07 07 07 07 07 07 07 07 
07 07 07 07 07 07 07 07 07 04 04 04 04 04 07 07 07 07 07 07 07 07 07 07 07 07 07 07 07 07 07 07 07 07 07 07 07 07 07 07 
07 07 07 07 07 07 07 07 07 04 04 04 04 04 07 07 07 07 07 07 07 07 07 07 07 07 07 07 07 07 07 07 07 07 07 07 07 07 07 07 
07 07 07 07 07 07 07 07 04 04 04 04 04 04 07 07 07 07 07 07 07 07 07 07 07 07 07 07 07 07 07 07 07 07 07 07 07 07 07 07 
07 07 07 07 07 07 07 07 04 04 04 04 04 04 04 04 04 04 04 04 04 04 04 04 04 04 04 04 04 04 04 07 07 07 07 07 07 07 07 07 
07 07 07 07 07 07 07 07 04 04 04 04 04 04 04 04 04 04 04 04 04 04 04 04 04 04 04 04 04 04 04 04 07 07 07 07 07 07 07 07 
07 07 07 07 07 04 04 04 04 04 04 04 04 04 04 04 04 04 04 04 04 04 04 04 04 04 04 04 04 04 04 04 07 07 07 07 07 07 07 07 
07 07 07 07 04 04 04 04 04 04 04 04 04 04 04 04 04 04 04 04 04 04 04 04 04 04 04 04 04 04 04 04 07 07 07 07 07 07 07 07 
07 07 07 07 04 04 04 04 04 04 04 04 04 04 04 04 04 04 04 04 04 04 04 04 04 04 04 04 04 04 04 04 07 07 07 07 07 07 07 07 
07 07 07 07 04 04 04 04 04 04 04 04 04 04 04 04 04 04 04 04 04 04 04 04 04 04 04 04 04 04 04 04 07 07 07 07 07 07 07 07 
07 07 07 07 04 04 04 04 04 04 04 04 04 04 04 04 04 04 04 04 04 04 04 04 04 04 04 04 04 04 04 04 07 07 07 07 07 07 07 07 
07 07 07 07 04 04 04 04 04 04 04 04 04 04 04 04 04 04 04 04 04 04 04 04 04 04 04 04 04 04 04 04 07 07 07 07 07 07 07 07 
07 07 07 07 07 04 04 04 04 04 04 04 04 04 04 04 04 04 04 04 04 04 04 04 04 04 04 04 04 04 04 04 04 07 07 07 07 07 07 07 
07 07 07 07 07 04 04 04 04 04 04 04 04 04 04 04 04 04 04 04 04 04 04 04 04 04 04 04 04 04 04 04 04 07 07 07 07 07 07 07 
07 07 07 07 07 07 04 04 04 04 04 07 04 04 04 04 04 04 04 04 04 04 04 04 04 04 04 04 04 04 04 04 04 07 07 07 07 07 07 07 
07 07 07 07 07 07 07 07 07 07 07 07 04 04 04 04 04 04 04 04 04 04 04 04 04 04 04 04 04 04 04 04 04 07 07 07 07 07 07 07 
07 07 07 07 07 07 07 07 07 07 07 07 07 04 04 04 04 04 04 04 04 04 04 04 04 04 04 04 04 04 04 04 04 07 07 07 07 07 07 07 
07 07 07 07 07 07 07 07 07 07 07 07 07 04 04 04 04 04 04 04 04 04 04 04 04 04 04 04 04 04 04 04 04 07 07 07 07 07 07 07 
07 07 07 07 07 07 07 07 07 07 07 07 07 04 04 04 04 04 04 04 04 04 04 04 04 04 04 04 04 04 04 07 07 07 07 07 07 07 07 07 
07 07 07 07 07 07 07 07 07 07 07 07 07 04 04 04 04 04 04 04 04 04 04 04 04 04 07 07 07 07 07 07 07 07 07 07 07 07 07 07 
07 07 07 07 07 07 07 07 07 07 07 07 07 07 04 04 04 04 04 04 04 04 04 04 04 07 07 07 07 07 07 07 07 07 07 07 07 07 07 07 
07 07 07 07 07 07 07 07 07 07 07 07 07 07 04 04 04 04 04 04 04 04 04 04 04 04 07 07 07 07 07 07 07 07 07 07 07 07 07 07 
07 07 07 07 07 07 07 07 07 07 07 07 07 04 04 04 04 04 04 04 04 04 04 04 04 04 04 04 04 04 07 07 07 07 07 07 07 07 07 07 
07 07 07 07 07 07 07 07 07 07 07 07 07 04 04 04 04 04 04 04 04 04 04 04 04 04 04 04 04 04 04 07 07 07 07 07 07 07 07 07 
07 07 07 07 07 07 07 07 07 07 07 07 07 04 04 04 04 04 04 04 04 04 04 04 04 04 04 04 04 04 04 07 07 07 07 07 07 07 07 07 
07 07 07 07 07 07 07 07 07 07 07 07 07 04 04 04 04 04 04 04 04 04 04 04 04 04 04 04 04 04 07 07 07 07 07 07 07 07 07 07 
07 07 07 07 07 07 07 07 04 04 04 04 04 04 04 04 04 04 04 04 04 04 04 04 04 04 04 04 04 04 07 07 07 07 07 07 07 07 07 07 
07 07 07 07 07 07 07 04 04 04 04 04 04 04 04 04 04 04 04 04 04 04 04 04 04 04 04 04 07 07 07 07 07 07 07 07 07 07 07 07 
07 07 07 07 07 07 07 04 04 04 04 04 04 04 04 04 04 04 04 04 04 04 04 04 04 04 04 04 07 07 07 07 07 07 07 07 07 07 07 07 
07 07 07 07 07 04 04 04 04 04 04 04 04 04 04 04 04 04 04 04 07 07 07 07 07 07 07 07 07 07 07 07 07 07 07 07 07 07 07 07 
07 07 07 07 07 04 04 04 04 04 04 04 04 04 04 04 04 04 04 07 07 07 07 07 07 07 07 07 07 07 07 07 07 07 07 07 07 07 07 07 
07 07 07 07 07 04 04 04 04 04 04 04 04 04 04 04 04 04 04 07 07 07 07 07 07 07 07 07 07 07 07 07 07 07 07 07 07 07 07 07 
07 07 07 07 07 04 04 04 04 04 04 04 04 04 04 04 04 04 04 07 07 07 07 07 07 07 07 07 07 07 07 07 07 07 07 07 07 07 07 07 
07 07 07 07 07 04 04 04 04 04 04 04 04 04 04 04 04 04 04 07 07 07 07 07 07 07 07 07 07 07 07 07 07 07 07 07 07 07 07 07 
07 07 07 07 07 04 04 04 04 04 04 04 04 04 04 04 04 04 04 07 07 07 07 07 07 07 07 07 07 07 07 07 07 07 07 07 07 07 07 07 
07 07 07 07 07 04 04 04 04 04 04 04 04 04 04 04 04 04 04 07 07 07 07 07 07 07 07 07 07 07 07 07 07 07 07 07 07 07 07 07 
07 07 07 07 07 07 04 04 04 04 04 04 04 04 04 04 04 04 04 04 04 04 04 04 07 07 07 07 07 07 04 04 04 04 04 04 04 07 07 07 
07 07 07 07 07 07 04 04 04 04 07 04 04 04 04 04 04 04 04 04 04 04 04 04 04 04 04 04 04 04 04 04 04 04 04 04 04 07 07 07 
07 07 07 07 07 07 07 07 07 07 07 07 04 04 04 04 04 04 04 04 04 04 04 04 04 04 04 04 04 04 04 04 04 04 04 04 04 07 07 07 
07 07 07 07 07 07 07 07 07 07 07 07 07 04 04 04 07 07 07 04 04 04 04 04 04 04 04 04 04 04 04 04 04 04 04 04 04 07 07 07 
07 07 07 07 07 07 07 07 07 07 07 07 07 07 07 07 07 07 07 04 04 04 04 04 04 04 04 04 04 04 04 04 04 04 04 04 07 07 07 07 
07 07 07 07 07 07 07 07 07 07 07 07 07 07 07 07 07 07 07 04 04 04 04 04 04 04 04 04 04 04 04 04 04 04 04 04 07 07 07 07 
07 07 07 07 07 07 07 07 07 07 07 07 07 07 07 07 07 07 07 07 04 04 04 04 04 04 04 04 04 04 04 04 07 07 07 04 07 07 07 07 
07 07 07 07 07 07 07 07 07 07 07 07 07 07 07 07 07 07 07 07 07 07 04 04 04 04 04 04 07 07 07 07 07 07 07 07 07 07 07 07 
07 07 07 07 07 07 07 07 07 07 07 07 07 07 07 07 07 07 07 07 07 07 04 04 04 04 04 04 07 07 07 07 07 07 07 07 07 07 07 07 
07 07 07 07 07 07 07 04 04 04 04 04 04 04 04 04 07 07 07 07 07 07 04 04 04 04 04 04 07 07 07 07 07 07 07 07 07 07 07 07 
07 07 07 07 07 07 04 04 04 04 04 04 04 04 04 04 04 06 06 06 06 06 04 04 04 04 04 04 07 07 07 07 07 07 07 07 07 07 07 07 
07 07 07 07 07 07 04 04 04 04 04 04 04 04 04 04 04 06 06 06 06 06 04 04 04 04 04 04 07 07 07 07 07 07 07 07 07 07 07 07 
07 07 07 07 07 07 04 04 04 04 04 04 04 04 04 04 04 06 06 06 06 06 04 04 04 04 04 04 07 07 07 07 07 07 07 07 07 07 07 07 
07 07 07 07 07 07 04 04 04 04 04 04 04 04 04 04 04 06 06 06 06 06 04 04 04 04 04 04 07 07 07 07 07 07 07 07 07 07 07 07 
07 07 07 07 07 07 07 04 04 04 04 04 04 04 04 04 04 06 06 06 06 04 04 04 04 04 04 04 07 07 07 07 07 07 07 07 07 07 07 07 
07 07 07 07 07 07 07 07 04 04 04 04 04 04 07 07 07 07 07 07 07 04 04 04 04 04 04 04 07 07 07 07 07 07 07 07 07 07 07 07 
07 07 07 07 07 07 07 07 07 07 07 07 07 07 07 07 07 07 07 07 07 07 04 04 04 04 04 04 07 07 07 07 07 07 07 07 07 07 07 07 
07 07 07 07 07 07 07 07 07 07 07 07 07 07 07 07 07 07 07 07 07 07 04 04 04 04 04 04 07 07 07 07 07 07 07 07 07 07 07 07 
07 07 07 07 07 07 07 07 07 07 07 07 07 07 07 07 07 07 07 07 07 07 04 04 04 04 04 04 07 07 07 07 07 07 07 07 07 07 07 07 
07 07 07 07 07 07 07 07 07 07 07 07 07 07 07 07 07 07 07 07 07 07 04 04 04 04 04 04 07 07 07 07 07 07 07 07 07 07 07 07 
07 07 07 07 07 07 07 07 07 07 07 07 07 07 07 07 07 07 07 07 07 04 04 04 04 04 04 04 04 07 07 07 07 07 07 07 07 07 07 07 
07 07 07 07 07 07 07 07 07 04 04 04 04 04 04 04 04 04 04 04 04 04 04 04 04 04 04 04 04 07 07 07 07 07 07 07 07 07 07 07 
07 07 07 07 07 07 07 07 04 04 04 04 04 04 04 04 04 04 04 04 04 04 04 04 04 04 04 04 04 07 07 07 07 07 07 07 07 07 07 07 
07 07 07 07 07 07 07 04 04 04 04 04 04 04 04 04 04 04 04 04 04 04 04 04 04 04 04 04 04 07 07 07 07 07 07 07 07 07 07 07 
07 07 07 07 07 07 04 04 04 04 04 04 04 04 04 04 04 04 04 04 04 04 04 04 04 04 04 04 07 07 07 07 07 07 07 07 07 07 07 07 
07 07 07 07 07 07 04 04 04 04 04 04 04 04 04 04 04 04 04 04 04 04 04 04 04 04 04 04 07 07 07 07 07 07 07 07 07 07 07 07 
07 07 07 07 07 07 04 04 04 04 04 04 04 04 04 04 04 04 04 04 04 04 04 04 04 04 04 04 07 07 07 07 07 07 07 07 07 07 07 07 
07 07 07 07 07 07 04 04 04 04 04 04 04 04 04 04 04 04 04 04 04 04 04 04 04 04 04 04 07 07 07 07 07 07 07 07 07 07 07 07 
07 07 07 07 07 07 04 04 04 04 04 04 04 04 04 04 04 04 04 04 04 04 04 04 04 04 04 04 07 07 07 07 07 07 07 07 07 07 07 07 
07 07 07 07 07 07 04 04 04 04 04 04 04 04 04 04 04 04 04 04 04 04 04 04 07 07 07 07 07 07 07 07 07 07 07 07 07 07 07 07 
07 07 07 07 04 04 04 04 04 04 04 04 04 04 04 04 04 04 04 04 04 04 04 04 07 07 07 07 07 07 07 07 07 07 07 07 07 07 07 07 
07 07 07 07 04 04 04 04 04 04 04 04 04 04 04 04 04 04 04 04 04 04 04 04 07 07 07 07 07 07 07 07 07 07 07 07 07 07 07 07 
07 07 07 07 07 04 04 04 04 04 04 04 04 04 04 04 04 04 04 04 04 04 04 04 07 07 07 07 07 07 07 07 07 07 07 07 07 07 07 07 
07 07 07 07 07 04 04 04 04 04 04 04 04 04 04 04 04 04 04 04 04 04 04 04 07 07 07 07 07 07 07 07 07 07 07 07 07 07 07 07 
07 07 07 07 07 07 04 04 04 04 04 04 04 04 04 04 04 04 04 04 04 04 04 04 07 07 07 07 07 07 07 07 07 07 07 07 07 07 07 07 
07 07 07 07 07 07 07 04 04 04 04 04 04 04 04 04 04 04 04 04 04 04 04 04 07 07 07 07 07 07 07 07 07 07 07 07 07 07 07 07 
07 07 07 07 07 07 07 07 07 07 07 07 07 07 07 07 04 04 04 04 04 04 04 04 07 07 07 07 07 07 07 07 07 07 07 07 07 07 07 07 
07 07 07 07 07 07 07 07 07 07 07 07 07 07 07 07 04 04 04 04 04 04 04 04 07 07 07 07 07 07 07 07 07 07 07 07 07 07 07 07 
07 07 07 07 07 07 07 07 07 07 07 07 07 07 07 07 04 04 04 04 04 04 04 04 07 07 07 07 07 07 07 07 07 07 07 07 07 07 07 07 
07 07 07 07 07 07 07 07 07 07 07 07 07 07 07 07 04 04 04 04 04 04 04 04 07 07 07 07 07 07 07 07 07 07 07 07 07 07 07 07 
07 07 07 07 07 07 07 07 07 07 07 07 07 07 07 07 04 04 04 04 04 04 04 04 07 07 07 07 07 07 07 07 07 07 07 07 07 07 07 07 
07 07 07 07 07 07 07 07 07 07 07 07 07 07 07 07 04 04 04 04 04 04 04 04 07 07 07 07 07 07 07 07 07 07 07 07 07 07 07 07 
07 07 07 07 07 07 07 07 07 07 07 07 07 07 07 07 04 04 04 04 04 04 04 04 07 07 07 07 07 07 07 07 07 07 07 07 07 07 07 07
portal 16 31 8 1 13 38 0
